{
	"tanks": [
		{ "type": "regular-tank", "count": 20 }
	],
	"map": [
		"..........................",
		"..........................",
		"..##..##..##..##..##..##..",
		"..##..##..##..##..##..##..",
		"..##..##..##..##..##..##..",
		"..##..##..##..##..##..##..",
		"..##..##..##@@##..##..##..",
		"..##..##..##@@##..##..##..",
		"..##..##..##..##..##..##..",
		"..##..##..........##..##..",
		"..##..##..........##..##..",
		"..........##..##..........",
		"..........##..##..........",
		"##..####..........####..##",
		"@@..####..........####..@@",
		"..........##..##..........",
		"..........######..........",
		"..##..##..######..##..##..",
		"..##..##..##..##..##..##..",
		"..##..##..##..##..##..##..",
		"..##..##..##..##..##..##..",
		"..##..##..........##..##..",
		"..##..##..........##..##..",
		"..##..##...####...##..##..",
		"...........#!!#...........",
		"...........#!!#..........."
	]
}